20 20
3 2
24 24 24 24 0 0 1 2 0 2 1 1 2 1 1 1 1 1 1 2
46 25 26 0 0 1 2 0 1 1 1 1 2 1 2 1 2 1 0 0
0 0 0 0 0 1 2 2 2 2 2 2 2 1 1 1 1 1 1 1
0 1 0 0 0 2 2 2 2 2 2 2 0 0 0 0 0 0 0 0
0 1 0 0 0 1 1 1 1 1 1 1 1 1 1 1 1 1 1 1
0 1 0 0 0 0 1 2 0 2 1 1 2 1 1 1 1 1 1 2 
0 1 0 0 0 1 2 0 1 1 1 1 2 1 2 1 2 1 0 0
0 1 0 0 0 1 2 2 2 2 2 2 2 1 1 1 1 1 1 1
0 1 0 0 0 2 2 2 2 2 2 2 0 0 0 0 0 0 0 0
0 1 0 0 0 1 1 1 1 1 1 1 1 1 1 1 1 1 1 1
0 1 0 0 0 0 1 2 0 2 1 1 2 1 1 1 1 1 1 2 
0 1 0 0 0 1 2 0 1 1 1 1 2 1 2 1 2 1 0 0
0 1 0 0 0 1 2 2 2 2 2 2 2 1 1 1 1 1 1 1
0 1 0 0 0 2 2 2 2 2 2 2 0 0 0 0 0 0 0 0
0 1 0 0 0 1 1 1 1 1 1 1 1 1 1 1 1 1 1 1
0 1 0 0 0 0 1 2 0 2 1 1 2 1 1 1 1 1 1 2 
0 1 0 0 0 1 2 0 1 1 1 1 2 1 2 1 2 1 0 0
0 1 0 0 0 1 2 2 2 2 2 2 2 1 1 1 1 1 1 1
0 1 0 0 0 2 2 2 2 2 2 2 0 0 0 0 0 0 0 0
0 1 0 0 0 1 2 2 2 2 2 2 2 1 1 1 1 1 1 1