30 30
222 223 223 223 0 0 24 224 0 0 0 0 0 0 0 0 0 0 180 0 0 0 0 237 238 239 0 224 0 0
244 245 245 245 222 223 224 246 0 0 0 0 0 0 0 0 0 0 202 0 0 0 0 0 0 0 202 246 0 0
266 267 267 267 244 245 246 268 0 0 0 0 0 0 0 0 0 0 202 0 0 0 0 0 0 0 202 268 0 0
0 0 0 0 266 267 268 0 0 0 0 0 0 0 0 0 0 223 224 0 0 0 0 0 0 0 224 0 0 0
0 0 0 0 0 0 0 0 0 0 0 0 0 0 0 0 202 245 246 0 0 0 0 0 0 202 246 0 0 0
0 0 0 0 0 0 0 0 0 0 0 0 0 339 250 223 224 267 268 0 0 0 0 0 0 202 268 0 0 0
222 0 0 0 0 0 0 0 0 0 0 223 224 361 272 245 246 0 0 0 0 0 223 223 339 224 0 0 0 0
244 222 223 223 223 0 0 0 0 0 202 245 246 383 267 267 268 0 0 0 0 224 294 295 361 246 0 0 0 0
266 244 245 245 245 222 223 223 247 223 224 267 268 0 0 0 0 0 0 0 202 246 316 317 383 268 0 0 0 0
223 266 267 267 267 244 245 245 269 245 246 0 0 223 223 0 0 0 0 0 202 228 0 0 0 0 0 0 0 0
245 222 223 223 0 266 267 267 267 267 268 0 202 245 245 222 0 0 0 0 202 0 0 0 0 0 0 0 0 0
267 244 245 245 222 223 223 223 223 223 223 250 224 267 267 244 222 184 185 223 224 0 0 0 0 0 0 0 0 0
0 266 267 267 244 245 245 245 245 245 245 272 246 0 0 266 244 206 207 245 246 0 0 0 0 0 0 0 0 0
0 0 0 0 266 267 267 267 267 267 267 267 268 0 0 0 266 227 229 228 268 0 0 0 0 0 0 0 0 0
0 0 0 0 0 0 0 0 0 0 0 0 0 0 0 0 0 0 0 0 0 0 0 0 0 0 0 0 0 0
0 0 0 0 0 0 0 0 0 0 0 0 0 0 0 0 0 0 0 0 0 0 0 0 0 0 0 0 0 0
0 0 0 0 0 0 0 0 0 0 0 0 0 0 0 0 0 0 0 0 0 0 0 0 0 0 0 0 0 0
0 0 0 0 0 0 0 0 0 0 0 0 0 0 0 0 0 0 0 0 0 0 0 0 0 0 0 0 0 0
0 0 0 0 0 0 0 0 0 0 0 0 0 0 0 0 0 0 0 0 0 0 0 0 0 0 0 0 0 0
0 0 0 0 0 0 0 0 0 0 0 0 0 0 0 0 0 0 0 0 0 0 0 0 0 0 0 0 0 0
0 0 0 0 0 0 0 0 0 0 0 0 0 0 0 0 0 0 0 0 0 0 0 0 0 0 0 0 0 0
0 0 0 0 0 0 0 0 0 0 0 0 0 0 0 0 0 0 0 0 0 0 0 0 0 0 0 0 0 0
0 0 0 0 0 0 0 0 0 0 0 0 0 0 0 0 0 0 0 0 0 0 0 0 0 0 0 0 0 0
0 0 0 0 0 0 0 0 0 0 0 0 0 0 0 0 0 0 0 0 0 0 0 0 0 0 0 0 0 0
129 130 0 0 0 0 0 0 0 0 0 0 0 0 0 0 0 0 0 0 0 0 0 0 0 0 0 0 0 0
151 152 0 0 0 0 0 0 0 0 0 0 0 24 24 24 24 0 0 0 0 0 0 0 0 0 0 0 0 0
173 174 322 322 326 0 0 0 0 0 0 0 0 0 0 0 0 0 0 0 0 0 0 0 0 0 0 0 0 0
195 196 344 344 348 0 0 0 0 0 0 0 0 0 0 0 0 0 0 0 0 0 0 0 0 0 0 0 0 0
366 367 368 369 370 0 0 0 0 0 0 0 0 0 0 0 0 0 0 0 0 0 0 0 0 0 0 0 0 0
388 389 390 391 0 0 0 0 0 0 0 0 0 0 0 0 0 0 0 0 0 0 0 0 0 0 0 0 0 0