30 30
0 0 0 0 276 277 278 0 0 0 0 0 0 0 0 0 0 0 0 0 0 0 0 0 0 0 0 0 0 0
0 0 0 0 0 0 0 0 0 0 0 0 0 0 0 0 0 0 0 0 0 0 0 0 0 0 187 188 0 342
423 0 0 0 0 0 0 422 423 0 0 0 0 0 0 0 0 0 0 0 0 0 0 0 0 0 0 0 0 364
0 0 0 0 0 0 0 0 0 0 0 0 0 0 0 0 0 0 0 0 0 0 0 0 0 0 0 0 0 386
0 0 0 0 0 0 0 0 0 0 0 0 0 0 0 0 0 0 0 0 0 0 0 0 0 0 0 0 70 408
0 0 0 0 0 0 0 0 0 0 0 0 0 0 0 0 0 0 0 0 0 0 0 0 0 0 0 0 0 0
0 0 0 0 0 0 0 0 0 0 0 0 0 0 0 0 0 0 0 0 0 0 0 0 0 0 31 0 0 0
0 0 0 0 0 0 0 0 0 0 0 0 0 0 0 0 0 0 0 0 0 0 0 0 0 0 31 0 0 146
0 0 0 0 0 0 0 0 0 0 0 0 0 0 0 0 0 0 0 0 0 0 0 0 0 0 30 0 127 128
0 0 0 0 0 0 0 0 0 0 0 0 0 0 0 0 0 0 0 0 0 0 0 31 0 30 0 0 149 150
0 0 0 0 0 0 0 0 0 0 0 0 0 0 0 0 0 0 0 0 0 0 30 30 0 30 0 0 171 172
0 0 0 0 0 0 0 0 0 0 0 0 0 0 0 0 0 0 0 0 0 30 30 0 0 30 0 0 126 127
0 0 0 0 0 0 0 0 0 0 0 0 0 31 70 0 0 0 0 0 0 0 0 0 0 30 0 0 148 149
35 30 30 0 0 0 0 0 0 0 0 0 0 30 30 31 0 0 0 0 0 0 0 0 0 29 0 0 170 171
57 0 0 0 0 0 0 0 0 0 0 0 0 0 0 30 30 94 95 30 30 0 0 0 0 0 29 0 192 193
0 35 0 0 0 0 0 0 0 0 0 0 0 0 0 0 0 0 0 0 0 0 0 0 0 0 29 31 214 215
37 0 0 0 0 0 0 0 0 0 0 0 0 0 0 0 0 0 0 0 0 0 0 0 0 0 0 30 236 237
59 0 0 0 0 0 0 0 0 0 0 0 0 118 0 0 0 0 0 0 0 0 0 0 0 0 0 0 0 0
56 0 0 39 40 0 0 0 0 0 0 0 0 0 0 0 0 0 0 0 0 0 0 0 0 0 0 0 0 0
0 116 0 61 0 0 0 0 68 69 0 0 0 0 0 0 0 0 0 0 0 0 0 0 0 0 0 0 0 0
0 0 0 61 62 0 0 0 0 0 0 0 0 0 0 0 0 0 0 0 0 0 0 0 0 0 0 0 0 0
0 420 421 61 63 69 70 0 0 0 0 0 0 0 0 0 0 0 0 0 0 0 0 0 0 0 0 0 0 0
116 442 443 83 85 0 0 0 0 0 0 0 0 0 0 0 0 0 0 0 0 0 0 0 0 0 0 0 0 0
0 0 24 24 0 0 0 0 0 0 0 0 0 0 0 0 0 0 0 0 0 0 0 0 0 0 0 0 0 0
79 0 0 0 0 0 0 0 0 0 0 0 0 0 0 0 0 26 0 0 0 0 0 0 0 0 0 0 0 0
126 127 128 129 130 0 0 137 138 51 0 0 0 0 0 0 0 26 0 0 0 0 0 0 0 0 0 0 0 0
148 149 150 151 152 0 0 0 0 0 0 0 0 0 0 0 0 0 0 0 0 0 0 0 0 0 0 0 0 0
173 150 172 173 174 0 136 122 123 124 125 121 122 123 124 125 0 0 0 0 0 0 0 0 0 0 0 0 0 0
0 0 0 0 0 0 143 144 145 146 147 143 144 145 146 147 0 0 0 0 0 0 0 0 0 0 0 0 0 0
0 0 0 0 0 0 165 166 167 168 169 165 166 167 168 169 0 0 0 0 0 0 0 0 0 0 0 0 0 0