30 30
24 24 24 24 24 24 24 24 31 31 30 24 39 40 40 40 41 24 24 30 24 24 24 24 24 24 24 24 24 24
24 24 24 24 24 24 24 24 31 30 24 24 61 46 42 43 46 41 24 30 24 24 24 24 24 24 31 24 24 24
24 24 24 24 24 24 24 30 30 24 24 39 42 43 64 65 62 85 24 30 39 40 41 24 24 24 31 31 24 24
40 40 40 41 24 24 24 24 24 39 40 62 64 65 62 62 85 85 24 30 61 42 43 40 41 24 24 31 24 24
84 84 62 62 40 40 40 39 40 62 62 62 62 62 84 85 24 24 24 30 61 64 65 62 63 24 24 31 31 24
24 24 83 84 84 62 62 62 62 62 84 84 84 84 85 24 24 24 30 30 61 85 83 62 63 24 31 31 31 31
24 24 24 24 24 83 85 83 84 85 24 24 24 24 24 24 24 30 30 39 62 24 24 24 24 24 31 31 31 31
24 24 24 24 24 24 24 24 24 24 24 24 24 24 24 24 31 24 39 62 24 24 294 295 24 24 31 31 31 31
24 24 24 24 24 24 24 24 24 24 24 24 30 83 40 40 40 40 62 62 24 24 316 317 24 31 31 31 31 24
31 31 24 24 24 24 24 24 24 24 24 30 24 24 24 24 62 62 62 62 24 31 31 24 61 31 31 31 24 24
24 31 31 31 31 24 24 24 24 24 24 24 24 24 24 24 24 83 84 85 24 31 31 31 61 31 31 31 24 24
24 24 24 24 24 24 24 24 24 24 24 24 24 24 24 24 24 24 24 24 24 31 24 24 61 31 31 31 24 24
30 31 24 24 24 24 24 24 24 24 24 24 24 31 31 24 24 24 24 24 31 30 24 39 62 31 31 31 24 24
24 31 31 31 24 24 24 24 24 24 24 24 24 24 24 31 24 24 24 24 31 29 39 62 85 31 31 31 24 24
24 24 24 24 24 24 24 24 24 24 24 24 24 24 24 24 31 31 31 31 31 24 61 63 24 24 31 31 31 31
24 24 24 30 24 0 0 0 31 31 31 31 24 24 24 24 24 24 24 24 24 24 61 63 24 27 31 31 30 30
24 24 24 30 24 24 24 24 30 30 30 30 24 24 24 24 24 24 24 24 24 39 62 85 24 27 26 31 31 26
24 24 24 30 30 30 30 30 24 24 24 24 24 24 24 24 24 39 40 40 40 62 85 24 24 24 26 33 34 35
40 40 40 40 41 24 24 24 24 24 24 24 39 40 40 40 40 62 64 65 84 85 24 24 24 24 24 55 56 56
84 84 84 62 62 40 40 41 24 24 24 39 62 62 62 62 62 62 62 85 24 24 24 24 24 24 33 56 56 56
24 24 24 83 84 84 62 62 40 40 40 62 62 62 85 24 24 24 24 24 24 24 24 24 24 24 55 56 56 56
24 24 24 24 24 24 83 62 62 62 62 62 84 85 24 24 24 24 24 24 24 24 24 24 24 33 56 56 56 56
24 24 24 24 24 24 24 83 62 62 62 85 24 24 24 24 24 24 24 24 24 24 33 34 34 56 56 56 56 56
24 24 24 24 24 24 24 24 61 62 63 24 24 24 24 24 24 24 24 24 24 24 55 56 56 56 56 36 37 56
30 30 24 24 24 24 24 24 61 62 64 24 24 24 24 24 24 24 24 24 24 24 55 56 56 56 56 58 59 56
24 24 30 30 24 24 24 24 61 63 64 24 24 24 24 24 24 24 24 24 24 33 56 56 56 56 56 56 56 56
24 24 24 30 30 24 24 24 83 84 85 24 24 24 24 24 24 24 24 24 24 55 36 37 56 56 56 56 56 56
24 24 24 24 30 24 24 24 24 24 24 24 24 24 24 24 24 24 24 24 33 56 58 59 56 56 56 56 56 56
24 24 24 24 30 30 24 61 62 63 24 24 24 24 24 24 24 24 24 33 56 56 56 56 56 56 56 56 56 36
24 24 24 24 30 30 24 83 84 85 24 24 24 24 24 24 24 24 24 55 56 56 56 56 56 56 56 56 56 58