30 30
0 247 0 0 0 0 0 0 0 0 0 0 0 0 0 0 0 0 0 237 238 239 216 217 0 0 170 171 172 173
0 269 207 0 0 184 0 0 0 0 0 0 0 0 0 0 0 0 0 0 0 237 238 239 0 0 192 193 194 195
0 0 229 0 0 206 0 0 0 0 0 0 0 0 0 0 0 0 0 0 0 0 0 0 0 0 214 215 216 217
0 0 159 160 0 117 0 0 0 0 0 0 0 0 0 0 0 247 0 0 0 0 0 0 0 0 236 237 238 239
0 0 0 0 0 0 0 0 0 0 0 0 0 0 118 0 0 269 0 0 0 0 0 0 119 0 0 0 0 24
0 0 0 119 0 0 0 0 0 0 0 0 0 0 0 249 0 135 0 0 0 0 0 0 0 424 0 0 0 321
0 0 0 0 0 0 0 0 0 0 0 0 0 0 0 271 0 0 117 0 0 0 0 0 0 0 0 0 0 343
0 0 0 0 0 0 0 0 0 0 0 0 0 0 0 0 0 420 421 0 0 0 0 0 0 0 0 72 0 343
0 0 0 207 0 0 249 185 0 0 0 0 0 0 0 0 0 442 443 0 0 0 0 117 0 135 0 0 321 344
0 0 0 229 0 0 271 207 0 207 0 0 0 0 0 0 0 0 0 0 0 0 0 0 0 0 0 321 322 344
0 0 0 0 0 0 0 0 0 229 0 0 0 0 0 0 0 0 0 0 0 0 0 0 0 0 0 343 344 344
0 0 0 0 0 0 0 0 0 0 0 0 0 135 0 0 0 0 0 0 0 0 0 0 0 0 0 365 366 366
0 0 0 0 0 0 0 207 0 0 0 0 0 0 0 0 0 0 0 0 0 0 0 0 0 0 0 387 388 388
0 0 0 0 0 0 0 229 0 0 0 0 0 0 0 0 0 0 0 0 0 0 0 0 0 0 0 118 410 410
35 0 0 30 0 0 0 0 0 0 0 0 0 30 0 0 0 0 0 0 0 0 0 0 0 0 0 431 432 432
56 35 0 0 0 0 0 0 0 0 0 0 0 0 0 0 0 0 0 0 0 0 0 0 0 0 0 0 0 0
56 57 0 0 0 0 0 0 0 0 0 0 0 0 0 0 0 0 0 0 0 0 420 421 0 0 0 0 0 0
56 56 35 0 0 0 0 0 0 0 0 0 0 0 0 0 0 0 0 0 0 0 442 443 0 0 0 0 0 117
56 56 57 0 0 0 0 0 0 0 0 0 0 0 0 0 0 0 0 0 0 0 0 0 0 0 0 135 0 0
56 56 57 0 0 0 0 0 0 0 0 0 0 0 0 0 0 0 0 0 0 0 0 0 0 68 0 0 0 0
56 56 57 0 0 0 0 0 0 0 0 0 0 53 0 0 0 0 0 0 0 0 0 0 72 0 0 0 0 0
56 56 79 0 0 0 0 0 0 0 0 0 0 0 0 0 0 0 0 0 0 0 0 0 75 0 0 0 0 0
56 57 0 0 0 0 0 0 0 0 0 422 423 0 0 0 0 0 0 0 0 0 159 160 158 0 0 0 0 0
56 79 0 0 0 0 0 0 0 0 0 0 0 0 0 0 0 0 0 0 0 0 0 0 157 0 0 0 0 0
0 0 0 0 0 0 0 0 0 0 0 0 0 0 0 0 0 0 0 0 0 70 0 0 0 0 0 0 0 0
0 0 0 0 0 0 0 0 0 0 0 0 0 0 0 0 0 0 0 68 0 0 0 0 0 0 0 0 0 0
0 0 0 0 0 0 0 0 0 0 0 0 0 0 0 0 0 0 0 159 160 0 0 0 0 0 0 0 0 0
0 0 0 0 0 0 0 0 0 0 0 0 0 0 0 0 0 0 0 0 0 0 0 0 0 0 0 0 0 0
0 0 0 121 122 123 124 125 121 122 123 124 125 0 121 122 123 124 125 0 0 0 0 0 0 0 0 0 0 0
0 0 0 143 144 145 146 147 143 144 145 146 147 0 143 144 145 146 147 0 0 0 0 0 0 0 0 0 0 0